------------------------------------------------------------
----------------------------?-------------------------------
-----------------------E------------------------------------
-------------???---------------------------------------------
-----------------------------???-----------------------------
-------------------E----------------------------------------
------------------------------------------------------------
XXXXXXXXXXXXXXXXXXXXXXXXXXXXXXXXXXXXXXXXXXXXXXXXXXXXXXXXXXXX