------------------------------------------------------------
------------------------E-----------------------------------
-------------------------???--------------------------------
--------------?---------------------------------------------
----------------------------E-------------------------------
-------------------???--------------------------------------
------------------------------------------------------------
XXXXXXXXXXXXXXXXXXXXXXXXXXXXXXXXXXXXXXXXXXXXXXXXXXXXXXXXXXXX