------------------------------------------------------------
--------------------------?---------------------------------
------------------------------E-----------------------------
----------------------???-----------------------------------
--------------E---------------------------------------------
-----------------------------?-------------------------------
------------------------------------------------------------
XXXXXXXXXXXXXXXXXXXXXXXXXXXXXXXXXXXXXXXXXXXXXXXXXXXXXXXXXXXX