------------------------------------------------------------
------------E-----------------------------?-----------------
----------------------???-----------------------------------
-------------------------------E----------------------------
-----------------------?------------------------------------
------------------------------------------------------------
------------------------------------------------------------
XXXXXXXXXXXXXXXXXXXXXXXXXXXXXXXXXXXXXXXXXXXXXXXXXXXXXXXXXXXX