------------------------------------------------------------
-------------------------E----------------------------------
----------------?????----------------------------------------
-----------------------------E------------------------------
--------??--------------------------------------------------
-------------------------------???---------------------------
------------------------------------------------------------
XXXXXXXXXXXXXXXXXXXXXXXXXXXXXXXXXXXXXXXXXXXXXXXXXXXXXXXXXXXX