------------------------------------------------------------
----------------E-------------------------------------------
----------------------???-----------------------------------
-----------------------------E------------------------------
---------???-------------------------------------------------
-------------------------------?-----------------------------
------------------------------------------------------------
XXXXXXXXXXXXXXXXXXXXXXXXXXXXXXXXXXXXXXXXXXXXXXXXXXXXXXXXXXXX