------------------------------------------------------------
----------------?-------------------------E-----------------
----------------------------???------------------------------
-------------------------E----------------------------------
----------???-----------------------------------------------
-------------------------------?----------------------------
------------------------------------------------------------
XXXXXXXXXXXXXXXXXXXXXXXXXXXXXXXXXXXXXXXXXXXXXXXXXXXXXXXXXXXX