------------------------------------------------------------
-----------?-------------------------------E----------------
-------------------------???--------------------------------
-------------------------------?----------------------------
-----E------------------------------------------------------
-------------------------???--------------------------------
------------------------------------------------------------
XXXXXXXXXXXXXXXXXXXXXXXXXXXXXXXXXXXXXXXXXXXXXXXXXXXXXXXXXXXX